Those sticky goo blocks slow you down. Jump off them!
40
..........W.......W.
.X........W.........
------...---....W...
...............iiIII
WWW...W..........W..
ggggg...W...........
.......W.WiiiiiIIGGG
W...W..............
##--#---..W.........
....................
.--#####-......W.W..
............######..
........W.......W.W.
.1.....W.W.....A.W.W
###GGGGGGGGGGGGGG###