Pick up all the water drops and reach the exit in time.
30
........................................
.................X......................
.0........##########....................
........................................
WWW....WW+W.............................
---....####.............................
........................................
WWW.....................................
###.........W+WWW.......................
............#####.......................
....WWW............R.....*..............
....###.................................
.................................*......
.1...>..................................
########################################